R 2000 1440
NO shanks.xpm
SO ayoub.xpm
WE maroc.xpm
EA hani.xpm
S eagle.xpm
F 150,200,254
C 50,80,255



111111111111111111111111111111111
100000000000000000000000000000011
100000000111110000000111100000001
100000000020000200000000000000001
100000000001111111111000000000001
11111100000000000000000000000011
10000000000000000002000200000001
10000000000000000000000000000001
1000000000000000000N000000000001
10000000000000000000000000200001
10000000000000000000000000000001
10000000000000000000000000000001
 11111111111111111111111111111111